##Northern Europe and Western Europe##
ADL = "countries/Andalusia.txt"
ADR = "countries/Andorra.txt"
ARS = "countries/Asturias.txt"
BGN = "countries/Burgundy.txt"
FLA = "countries/Flanders.txt"
MCO = "countries/Monaco.txt"
NRM = "countries/Normandy.txt"
PRV = "countries/Provence.txt"
SAA = "countries/Saami.txt"
WLL = "countries/Wallonia.txt"

##Italy##
EMR = "countries/Emilia-Romagna.txt"
KTS = "countries/Kingdom of Two Sicilies.txt"
PDM = "countries/Piedmont.txt"
SMR = "countries/San Marino.txt"
SRD = "countries/Sardinia.txt"
TUS = "countries/Tuscany.txt"
VCT = "countries/Vatican.txt"
VEC = "countries/Venice.txt"

##Germany and Central Europe##
BDN = "countries/Baden.txt"
BUK = "countries/Bukovina.txt"
DAN = "countries/Danzig.txt"
GAL = "countries/Galicia-Lodomeria.txt"
LIE = "countries/Liechtenstein.txt"
LUS = "countries/Sorbia.txt"
MRV = "countries/Moravia.txt"
RHN = "countries/Rhineland.txt"
SAR = "countries/Saar.txt"
SIL = "countries/Silesia.txt"
THU = "countries/Thuringia.txt"
ZKR = "countries/Carpatho-Ruthenia.txt"

##Balkans##
BNT = "countries/Banat.txt"
SCS = "countries/State of Serbs Croats and Slovenes.txt"
THR = "countries/Thrace.txt"

##Eastern Europe and European Russia##
ATK = "countries/Astrakhan.txt"
BSH = "countries/Bashkiria.txt"
CHV = "countries/Chuvashia.txt"
CRE = "countries/Crimea.txt"
CUR = "countries/Kurland.txt"
DON = "countries/Don.txt"
ERZ = "countries/Erzyat.txt"
IDL = "countries/Idel-Ural.txt"
ING = "countries/Ingria.txt"
KAR = "countries/Karelia.txt"
KLM = "countries/Kalmykia.txt"
KOM = "countries/Komi.txt"
KUB = "countries/Kuban.txt"
LBU = "countries/Eastern Ukraine.txt"
MRI = "countries/Mari.txt"
TAT = "countries/Tatarstan.txt"
TRK = "countries/Terek.txt"
UDM = "countries/Udmurtia.txt"
VLG = "countries/Volga Germany.txt"
VPS = "countries/Vepsia.txt"

##Caucasus##
ABH = "countries/Abkhazia.txt"
ADY = "countries/Adygea.txt"
CHE = "countries/Chechen.txt"
DGH = "countries/Dagestan.txt"
IGS = "countries/Ingushetia.txt"
KBR = "countries/Kabardino-Balkaria.txt"
KRC = "countries/Karachay-Cherkessia.txt"
NCC = "countries/Northern Caucasia.txt"
SOT = "countries/South Ossetia.txt"
TCF = "countries/Transcaucasia.txt"

##North America##
ALK = "countries/Alaska.txt"
CAL = "countries/California.txt"
CSD = "countries/Cascadia.txt"
DSR = "countries/Deseret.txt"
GRL = "countries/Greenland.txt"
NEG = "countries/New England.txt"
NFL = "countries/New Foundland.txt"
NYK = "countries/New York.txt"
QUE = "countries/Quebec.txt"
TEX = "countries/Texas.txt"
YCT = "countries/Yucatan.txt"

##South America##
PTG = "countries/Patagonia.txt"

##Anatolia and the Middle-East##
ASY = "countries/Assyria.txt"
BHR = "countries/Bahrain.txt"
BSR = "countries/Basra.txt"
CLC = "countries/Cilicia.txt"
CPD = "countries/Cappadocia.txt"
HAS = "countries/Al-Haasa.txt"
HJZ = "countries/Hejaz.txt"
JBL = "countries/Jabal Shammar.txt"
PTS = "countries/Pontus.txt"
SYE = "countries/South Yemen.txt"

##China and East Asia##
DPK = "countries/North Korea.txt"
HKG = "countries/Hongkong.txt"
HSI = "countries/Hsikang Clique.txt"
KML = "countries/Kumul.txt"
MCU = "countries/Macau.txt"
NEA = "countries/Northeastern Army.txt"
NSI = "countries/Ningsia Ma Clique.txt"
ROK = "countries/South Korea.txt"
RYU = "countries/Ryukyu.txt"
SHG = "countries/Shangdong.txt"
SZH = "countries/Szechwan Clique.txt"
TUG = "countries/Tunganistan.txt"

##India##
ASM = "countries/Assam.txt"
BLC = "countries/Balochistan.txt"
GJT = "countries/Gujarat.txt"
HND = "countries/Hindustan.txt"
HYD = "countries/Hyderabad.txt"
JMK = "countries/Jammu and Kashmir.txt"
KHL = "countries/Khalistan.txt"
MHR = "countries/Maharashtra.txt"
MYS = "countries/Mysore.txt"
ORS = "countries/Orissa.txt"
PJB = "countries/Punjab.txt"
RJP = "countries/Rajasthan.txt"
SKM = "countries/Sikkim.txt"
SND = "countries/Sindh.txt"
TML = "countries/Tamil Nadu.txt"
TVC = "countries/Travancore.txt"

##Persia and Central Asia##
BQR = "countries/Bukhara.txt"
GIL = "countries/Gilan.txt"
HZR = "countries/Hazarastan.txt"
KHV = "countries/Khiva.txt"
KHZ = "countries/Khuzestan.txt"
LUR = "countries/Lurestan.txt"
MZN = "countries/Mazandaran.txt"
PSH = "countries/Pashtunistan.txt"
SAZ = "countries/Iranian Azerbaijan.txt"
TQS = "countries/Turkestan.txt"

##Siberia and Russia East of the Urals##
ALT = "countries/Altai.txt"
BUY = "countries/Buryatia.txt"
FER = "countries/Far Eastern Republic.txt"
SIB = "countries/Siberia.txt"
YAK = "countries/Yakut.txt"

##Southeast Asia##
ACH = "countries/Aceh.txt"
BLI = "countries/Bali.txt"
BOR = "countries/Borneo.txt"
BRU = "countries/Brunei.txt"
IDC = "countries/Indochina.txt"
JAV = "countries/Java.txt"
KCN = "countries/Kachin.txt"
MLK = "countries/Maluku.txt"
NST = "countries/Nusa Tenggara.txt"
SAR = "countries/Sarawak.txt"
SHN = "countries/Shan.txt"
SNG = "countries/Singapore.txt"
SUL = "countries/Sulawesi.txt"

##Africa##
AHG = "countries/Ahaggar.txt"
AIR = "countries/Air.txt"
AZW = "countries/Azawad.txt"
BIA = "countries/Biafra.txt"
BNN = "countries/Benin.txt"
CYR = "countries/Cyrenaica.txt"
DRF = "countries/Darfur.txt"
EAF = "countries/Equatorial African Federation.txt"
HAU = "countries/Hausaland.txt"
KNG = "countries/Kongo.txt"
KSI = "countries/Kasai.txt"
KTG = "countries/Katanga.txt"
KVU = "countries/Kivu.txt"
LES = "countries/Lesotho.txt"
LNG = "countries/Lingalaland.txt"
SAO = "countries/Sao Tome.txt"
SMA = "countries/Somaliland.txt"
SWA = "countries/Swaziland.txt"
TBL = "countries/Toubouland.txt"
WAF = "countries/West African Federation.txt"
WDI = "countries/Wadai.txt"
XHO = "countries/Xhosaland.txt"
ZUL = "countries/Zululand.txt"
ZNZ = "countries/Zanzibar.txt"

##Pacific##
ETM = "countries/East Timor.txt"
HAW = "countries/Hawaii.txt"
KIR = "countries/Kiribati.txt"
MRS = "countries/Marshall.txt"
NAU = "countries/Nauru.txt"
PLU = "countries/Palau.txt"
POY = "countries/Polynesian Federation.txt"
VAN = "countries/Vanuatu.txt"